11111111
1PCE1111
100000C1
100H0111
100H0001
1CCVCCC1
11111111