11111111111111111111
1P0000000000000000H1
10C00000000000000H01
100C000000000000H001
1000C0000000000H0001
10000CC0000000H00001
1000000CC0000H000001
100000000CCCH0000001
10000000000HCC000001
1000000000H000C00001
1VVVVVVVVVVVVVVCVVV1
10000000H000000C0001
1000000H00000000C001
100000H000000000C001
10000H00000000000C01
1000H000000000000CV1
100H00000000000000C1
1VHV0V0V0V0V00V0VVC1
1HV0V0V0V0V00V0V00E1
11111111111111111111