1111111111
1CCCC1CCC1
1C000000C1
1C000H00C1
1110VPV011
1C000H0001
1C11000V01
1C11010V01
1CCCH1CCE1
1111111111