1111111111111111111111111
1VVVVVVVVVVVVVVVVVVVVVVH1
1H000000000000000000000H1
1H000000000000000C00000H1
1H000000000000H0C000000H1
1H0000000000000C0000000H1
1H000000000000C00000000H1
1H00000000000C000000000H1
1H00000000P000000000000H1
1H000000000CC0000000000H1
1H01000000C10C000000000H1
1H01000100010C000000000H1
1H0010101010C0000000000H1
1H0010101010C0000000000H1
1H000100010C11101000000H1
1H00000CCCC010000100000H1
1H0000C0000000000101000H1
1H0000C0000011111001000H1
1H0000C0000010000001000H1
1H0000C0000010000001000H1
1H0000C0000010000000000H1
1H00000C000000000001000H1
1H000000CCCCCCCCCCCCCCEH1
1HVVVVVVVVVVVVVVVVVVVVVV1
1111111111111111111111111