1111111111111111111111
10000000000000000H0001
10011110000000010H0101
1001CC100100C0010H01C1
10C1CC00E100C0010C01C1
10000000000000000H0001
10011110000000010H0101
1001CC100100C0010H01C1
10C1CC000000C0010C01C1
100000000HV00CCC0H0001
10C11110000000100H0101
1CPC1C100100C0010H01C1
10C1CC000100C0010C01C1
1111111111111111111111