111111111111111111111
1PCV0C0CV0C00C0CV0HE1
1C0V00V00V0CVVV0V0V01
111111111111111111111