1111111111
1P00CCCCC1
10000V00V1
100H111111
1CCCCCCCC1
111111H001
1CCCCCCCC1
100H111111
1CCCCCCCE1
1111111111