1111111111
1000000001
1001111H01
1001CC1V01
1PE1CC0001
1111111111