111111111111111111111111111111111111111111
1000P0000000000000001100000000000000000001
1000C000000000000000110000000CCCCC00000001
1000C00000000000000011000000C00000C0000001
1000C00000000000V0001100000C0000000CC00001
1000C00000C0000V0000110000C00000H0000C0001
10000C0000000V00000011000C00000000000C0001
10000C0H000VV0H000001100C000000000000C0001
10000C0000000CC000001100C000000000000C0001
10000C000000C00C00001100C00000H000000C0001
10V000C00000C00CC0001100C0000V0000000C0001
100000C00000C0100C001100C00H000000000C0001
1000000CCCCC01000C001100C00000000CCCCC0001
100000H00001100000C01100C00000000C00000001
100000000H01000000C01100C00000000C00000001
1000000C000100000C001100C000000CC0000H0001
1000000H00010000C000110C0000CCC00000000001
10000000000100000CCH00CCCCCCC0000000000001
1111111111111111111HVV01111111111111111111
1000C00000000000000C0HC00000000H0000000001
1000C0000001000000C0110C000000000000000001
1000C000001H00000C001100C00000001111111101
1000C000001000V00C0011000C0000001CVH000001
1000C000001000000C00110000C000001000H00001
10000C0H001000000C001100000C00001000000001
10000C00000C000000C011000000C0001111111111
10000C0000000CC0000C110000000C000000000001
10000C000000C00C000C1100000000C000H0000001
100000C00000C00CC00C11000000000C0000000001
1C0000C00000C0000CC011000000V000C000000001
1000000CCCCC00000C001100000000000C00000001
100000000000000000C0110000H0000000C0000001
100000000000C00000C0110000000000000C000001
10000V00000000000C0011000C0000000000C00001
100000H000000000C000110000000000HV000C0001
1CCCCCCCCCCCCCCC0000110000000000000000CCE1
111111111111111111111111111111111111111111