111111111111111111111111111111111111111111
1000P0000000000000001100000000000000000001
10000E000000000000001100000000000000000001
100000000000000000001110000000000000000001
100000000000000000001110000000000000000001
100000000000000000001100000000000000000001
100000000000000000001110000000000000000001
100000000000000000001110000000000000000001
100000000000000000001110000000000000000001
100000000000000000001110000000000000000001
100000000000000000001110000000000000000001
100000000000000000001110000000000000000001
100000000000000000001110000000000000000001
100000000000000000001110000000000000000001
100000000000000000001110000000000000000001
100000000000000000001110000000000000000001
100000000000000000001110000000000000000001
100000000000000000001110000000000000000001
100000000000000000001110000000000000000001
100000000000000000001110000000000000000001
100000000000000000001110000000000000000001
100000000000000000001110000000000000000001
100000000000000000001110000000000000000001
100000000000000000001110000000000000000001
100000000000000000001110000000000000000001
100000000000000000001110000000000000000001
100000000000000000001110000000000000000001
100000000000000000001110000000000000000001
100000000000000000001110000000000000000001
111111111111111111111111111111111111111111