11111111111111111111111
1P00000000CC0000CC000E1
10000000000000000000001
10000000000000000000001
10000000000000000000001
10000000000000000000001
10000000000000000000001
10000000000000000000001
10000000000000000000001
10000000000000000000001
10000000000000000000001
10000000000000000000001
10000000000000000000001
10000000000000000000001
10000000000000000000001
10000000000000000000001
10000000000000000000001
10000000000000000000001
10000000000000000000001
10000000000000000000001
10000000000000000000001
10000000000000000000001
10000000000000000000001
10000000000000000000001
10000000000000000000001
11111111111111111111111