1111111111111
1C00000V00001
10100CV0V00H1
1C100V000V0H1
1C10V0000V001
1P1V0H000CVE1
1111111111111